ONS Code,Region/Local Authority,Dry,Wet or flood,Snow or ice,Fatal,Serious,Slight,All
E12000001,North East,3741,1659,612,49,727,5236,6012
E06000047,County Durham,688,346,139,14,149,1010,1173
E06000005,Darlington,162,57,25,2,28,214,244
E08000020,Gateshead,364,173,46,6,71,506,583
E06000001,Hartlepool,100,26,16,0,27,115,142
E06000002,Middlesbrough,218,53,36,0,30,277,307
E08000021,Newcastle upon Tyne,489,228,53,3,85,682,770
E08000022,North Tyneside,282,110,33,4,36,385,425
E06000048,Northumberland,461,281,113,12,116,727,855
E06000003,Redcar and Cleveland,153,45,29,2,34,191,227
E08000023,South Tyneside,205,80,27,1,31,280,312
E06000004,Stockton-on-Tees,212,63,45,0,40,280,320
E08000024,Sunderland,407,197,50,5,80,569,654
E12000002,North West,11623,4473,1244,181,2444,14721,17346
E06000008,Blackburn with Darwen,261,110,39,1,56,353,410
E06000009,Blackpool,367,102,30,4,58,437,499
E08000001,Bolton,410,141,28,7,78,494,579
E08000002,Bury,230,93,23,5,50,291,346
E06000049,Cheshire East,696,345,70,11,213,887,1111
E06000050,Cheshire West and Chester,626,268,55,15,162,772,949
E10000006,Cumbria,801,359,124,25,167,1092,1284
E06000006,Halton,215,66,22,4,35,264,303
E08000011,Knowsley,199,89,41,3,40,286,329
E10000017,Lancashire,2293,926,305,39,571,2920,3530
E08000012,Liverpool,946,298,90,10,202,1122,1334
E08000003,Manchester,991,366,68,11,151,1263,1425
E08000004,Oldham,310,99,24,9,60,364,433
E08000005,Rochdale,271,112,21,2,41,361,404
E08000006,Salford,350,115,32,4,67,426,497
E08000014,Sefton,371,147,39,3,66,488,557
E08000013,St. Helens,215,87,25,2,40,285,327
E08000007,Stockport,333,121,25,5,49,425,479
E08000008,Tameside,260,78,22,5,48,307,360
E08000009,Trafford,284,103,25,0,47,365,412
E06000007,Warrington,429,175,51,8,89,558,655
E08000010,Wigan,343,129,37,5,56,448,509
E08000015,Wirral,422,144,48,3,98,513,614
E12000003,Yorkshire and The Humber,9163,3590,1038,161,1965,11665,13791
E08000016,Barnsley,348,176,48,6,55,511,572
E08000032,Bradford,965,383,91,10,177,1252,1439
E08000033,Calderdale,316,114,47,3,65,409,477
E08000017,Doncaster,636,241,68,15,115,815,945
E06000011,East Riding of Yorkshire,514,182,96,17,153,622,792
E06000010,"Kingston upon Hull, City of",521,181,24,3,114,609,726
E08000034,Kirklees,716,293,79,9,117,962,1088
E08000035,Leeds,1391,458,105,19,265,1670,1954
E06000012,North East Lincolnshire,296,106,44,1,66,379,446
E06000013,North Lincolnshire,312,120,70,5,87,410,502
E10000023,North Yorkshire,1044,437,173,43,375,1236,1654
E08000018,Rotherham,407,191,49,5,45,597,647
E08000019,Sheffield,859,374,62,5,142,1148,1295
E08000036,Wakefield,529,224,50,16,133,654,803
E06000014,York,309,110,32,4,56,391,451
E12000004,East Midlands,7696,3276,1098,166,1669,10389,12224
E06000015,Derby,540,201,57,1,83,714,798
E10000007,Derbyshire,1241,592,189,29,240,1753,2022
E06000016,Leicester,682,254,41,4,78,895,977
E10000018,Leicestershire,996,449,121,34,171,1361,1566
E10000019,Lincolnshire,1388,696,272,42,359,2033,2434
E10000021,Northamptonshire,853,370,106,24,251,1054,1329
E06000018,Nottingham,646,207,53,6,122,824,952
E10000024,Nottinghamshire,1290,483,249,18,353,1681,2052
E06000017,Rutland,60,24,10,8,12,74,94
E12000005,West Midlands,8948,3667,1134,145,1506,12098,13749
E08000025,Birmingham,1959,743,174,28,346,2502,2876
E08000026,Coventry,409,158,35,2,82,518,602
E08000027,Dudley,355,160,40,3,85,467,555
E06000019,"Herefordshire, County of ",297,131,47,7,48,420,475
E08000028,Sandwell,444,201,53,6,79,613,698
E06000051,Shropshire,453,197,58,18,82,608,708
E08000029,Solihull,284,104,28,3,57,356,416
E10000028,Staffordshire,1552,686,275,29,157,2327,2513
E06000021,Stoke-on-Trent,448,215,68,2,42,687,731
E06000020,Telford and Wrekin,213,73,40,2,31,293,326
E08000030,Walsall,373,143,39,5,60,490,555
E10000031,Warwickshire,981,408,117,23,240,1243,1506
E08000031,Wolverhampton,341,137,36,3,78,433,514
E10000034,Worcestershire,839,311,124,14,119,1141,1274
E12000006,East of England,9222,4097,1159,186,2115,12177,14478
E06000055,Bedford,267,114,27,1,52,355,408
E10000003,Cambridgeshire,1160,541,142,30,276,1537,1843
E06000056,Central Bedfordshire,440,176,70,12,116,558,686
E10000012,Essex,2049,896,207,44,561,2547,3152
E10000015,Hertfordshire,1699,764,239,27,341,2334,2702
E06000032,Luton,348,144,24,3,57,456,516
E10000020,Norfolk,1121,494,181,36,256,1504,1796
E06000031,Peterborough,485,182,41,6,79,623,708
E06000033,Southend-on-Sea,309,102,24,4,55,376,435
E10000029,Suffolk,1063,564,185,20,265,1527,1812
E06000034,Thurrock,281,120,19,3,57,360,420
E12000007,London,18762,4670,713,124,2627,21394,24145
E09000002,Barking and Dagenham,366,67,14,3,39,405,447
E09000003,Barnet,870,285,52,9,112,1086,1207
E09000004,Bexley,319,136,17,2,57,413,472
E09000005,Brent,611,129,38,3,76,699,778
E09000006,Bromley,488,160,32,3,80,597,680
E09000007,Camden,678,157,21,7,101,748,856
E09000001,City of London,292,42,1,1,40,294,335
E09000008,Croydon,698,183,35,5,81,830,916
E09000009,Ealing,678,171,20,3,78,788,869
E09000010,Enfield,604,197,29,7,86,737,830
E09000011,Greenwich,531,140,23,5,90,599,694
E09000012,Hackney,608,137,32,5,93,679,777
E09000013,Hammersmith and Fulham,485,108,11,2,70,532,604
E09000014,Haringey,621,162,14,1,76,720,797
E09000015,Harrow,339,73,16,2,31,395,428
E09000016,Havering,468,116,35,4,55,560,619
E09000017,Hillingdon,603,184,35,8,68,746,822
E09000018,Hounslow,624,124,22,7,83,680,770
E09000019,Islington,603,118,24,2,77,666,745
E09000020,Kensington and Chelsea,553,145,10,3,75,630,708
E09000021,Kingston upon Thames,282,53,8,1,43,299,343
E09000022,Lambeth,883,200,23,2,149,955,1106
E09000023,Lewisham,619,161,18,3,100,695,798
E09000024,Merton,310,67,10,2,37,348,387
E09000025,Newham,582,158,25,5,69,691,765
E09000026,Redbridge,583,136,18,3,73,661,737
E09000027,Richmond upon Thames,338,66,8,1,68,343,412
E09000028,Southwark,755,218,29,8,155,839,1002
E09000029,Sutton,300,73,16,2,44,343,389
E09000030,Tower Hamlets,704,139,18,6,83,772,861
E09000031,Waltham Forest,481,134,18,2,59,572,633
E09000032,Wandsworth,722,154,21,3,99,795,897
E09000033,Westminster,1131,271,19,4,177,1240,1421
E09000018,London Airport (Heathrow),33,6,1,0,3,37,40
E12000008,South East,15819,5739,1500,270,3239,19551,23060
E06000036,Bracknell Forest,155,62,13,4,20,206,230
E06000043,Brighton and Hove,700,173,29,7,123,772,902
E10000002,Buckinghamshire,872,284,105,18,163,1080,1261
E10000011,East Sussex,932,293,98,19,269,1035,1323
E10000014,Hampshire,2222,800,155,34,561,2582,3177
E06000046,Isle of Wight,269,103,28,3,72,325,400
E10000016,Kent,2904,1084,289,54,426,3798,4278
E06000035,Medway,392,135,32,2,55,502,559
E06000042,Milton Keynes,430,167,50,7,61,580,648
E10000025,Oxfordshire,1063,444,145,40,312,1300,1652
E06000044,Portsmouth,444,121,17,2,89,491,582
E06000038,Reading,267,85,7,3,36,320,359
E06000039,Slough,314,112,26,2,37,413,452
E06000045,Southampton ,495,138,17,3,119,528,650
E10000030,Surrey,2458,1027,318,32,454,3317,3803
E06000037,West Berkshire,206,83,34,10,44,269,323
E10000032,West Sussex,1244,474,96,27,319,1468,1814
E06000040,Windsor and Maidenhead,257,67,21,2,44,299,345
E06000041,Wokingham,195,87,20,1,35,266,302
E12000009,South West,8906,2883,683,178,1574,10720,12472
E06000022,Bath and North East Somerset,250,91,30,8,28,335,371
E06000028,Bournemouth,418,80,16,3,70,441,514
E06000023,"Bristol, City of",843,210,34,4,118,965,1087
E06000052,Cornwall,918,414,81,23,149,1241,1413
E10000008,Devon,1216,467,117,24,230,1546,1800
E10000009,Dorset,762,187,81,10,180,840,1030
E10000013,Gloucestershire,760,301,85,25,144,977,1146
E06000053,Isles of Scilly,1,0,0,0,0,1,1
E06000024,North Somerset,362,83,20,3,50,412,465
E06000026,Plymouth,527,167,22,4,54,658,716
E06000029,Poole,341,60,5,4,47,355,406
E10000027,Somerset,918,284,70,30,179,1063,1272
E06000025,South Gloucestershire,458,137,26,11,67,543,621
E06000030,Swindon,265,98,23,7,51,328,386
E06000027,Torbay,276,68,7,1,31,319,351
E06000054,Wiltshire,591,236,66,21,176,696,893
E92000001,England,93880,34054,9181,1460,17866,117951,137277